青辉石	qing'hui'shi	4
信用点	xin'yong'dian	4
体力	ti'li	1
神明文字碎片	shen'ming'wen'zi'sui'pian	4
总力战币	zong'li'zhan'bi	4
大决战币	da'jue'zhan'bi	4
战术大赛币	zhan'tu'da'sai'bi	4
战术考试币	zhan'tu'kao'shi'bi	4
精通证书	jing'tong'zheng'shu	4
悬赏通缉币	xuan'shang'tong'ji'bi	4
启动石	qi'dong'shi	4
制造石	zhi'zao'shi	4
启动石碎片	qi'dong'shi'sui'pian	4
制造石碎片	zhi'zao'shi'sui'pian	4
合成用启动石	he'cheng'yong'qi'dong'shi	4
合成石	he'cheng'shi	4
定向石	ding'xiang'shi	4
活动报告	huo'dong'bao'gao	4
经验书	jing'yan'shu	4
强化珠	qiang'hua'zhu	4
武器珠子	wu'qi'zhu'zi	4
弹簧	tan'huan	4
专武材料	zhuan'wu'cai'liao	4
战术笔记	zhan'tu'bi'ji	4
奥秘之书	ao'mi'zhi'shu	4
装备	zhuang'bei	4
爱用品	ai'yong'pin	4
礼物	li'wu	1
