联邦学生会	lian'bang'xue'sheng'hui	8
阿拜多斯	a'bai'duo'si	8
格黑娜	ge'hei'na	8
歌赫娜	ge'he'na	8
三一	san'yi	8
圣三一	sheng'san'yi	8
崔尼蒂	cui'ni'di	8
千年	qian'nian	8
千禧年	qian'xi'nian	8
百鬼夜行	bai'gui'ye'xing	8
山海经	shan'hai'jing	8
赤冬	chi'dong	8
阿里乌斯	a'li'wu'si	8
瓦尔基里	wa'er'ji'li	8
女武神	nv'wu'shen	8
克洛卢斯	ke'luo'lu'si	8
奥德赛	ao'de'sai	8
数秘会	shu'mi'hui	8
对策委员会	dui'ce'wei'yuan'hui	8
庆典事务局	qing'dian'shi'wu'ju	8
阿拜多斯理事会	a'bai'duo'si'li'shi'hui	8
风纪委员会	feng'ji'wei'yuan'hui	8
便利屋	bian'li'wu	8
美食研究会	mei'shi'yan'jiu'hui	8
万魔殿	wan'mo'dian	8
供餐部	gong'can'bu	8
温泉开发部	wen'quan'kai'fa'bu	8
急救医学部	ji'jiu'yi'xue'bu	8
回家部	hui'jia'bu	8
茶话会	cha'hua'hui	8
甜点部	tian'dian'bu	8
正义实现部	zheng'yi'shi'xian'bu	8
补习部	bu'xi'bu	8
姐妹会	jie'mei'hui	8
救护骑士团	jiu'hu'qi'shi'tuan	8
研讨会	yan'tao'hui	8
女仆部	nv'pu'bu	8
真理社	zhen'li'she	8
游戏开发部	you'xi'ka'fa'bu	8
工程部	gong'cheng'bu	8
超自然现象调查部	chao'zi'ran'xiang'xiang'diao'cha'bu	8
健身部	jian'shen'bu	8
阴阳部	yin'yang'bu	8
忍术研究部	ren'shu'yan'jiu'bu	8
修行部	xiu'xing'bu	8
百花缭乱纠纷调解委员会	bai'hua'liao'luan'jiu'fen'diao'jie'wei'yuan'hui	8
庆典运营管理部	qing'dian'yun'ying'guan'li'bu	8
